# Constants
REMOTE_ERROR	LITERAL1
CONNECT_ERROR	LITERAL1
INVALID_PARAM	LITERAL1
TIMEOUT_ERROR	LITERAL1
MODULE_ERROR	LITERAL1
DEFAULT_ERR	LITERAL1
SUCCESS	LITERAL1


# Public functions
reset	KEYWORD2
restore	KEYWORD2
writeConfig	KEYWORD2
connect	KEYWORD2
connectionState	KEYWORD2
disconnect	KEYWORD2
getAddress	KEYWORD2
numAddresses	KEYWORD2
sendData	KEYWORD2
BLECentral	KEYWORD2
BLEPeripheral	KEYWORD2
amCentral	KEYWORD2
BLEAdvertise	KEYWORD2
BLENoAdvertise	KEYWORD2
BLEScan	KEYWORD2
setBaudRate	KEYWORD2
addressQuery	KEYWORD2
stdGetParam	KEYWORD2
stdSetParam	KEYWORD2
stdCmd	KEYWORD2

# Class names and data types
BLEMate2	KEYWORD1
opResult	KEYWORD1
